R 800 600
NO /Users/louise/cub3d/textures/Texlibnubrick1.gif
SO /Users/louise/cub3d/textures/Texlibbrickstonesamples.gif
WE /Users/louise/cub3d/textures/Texlibbrickstonesample2.gif
EA /Users/louise/cub3d/textures/Texlibbrickstonesample3.gif

S /Users/louise/cub3d/textures/tiles.gif
F 220,100,5
C 225,30,8

        1111111111111111111111111
        1000000000110000000000001
        1011000001110000002000001
        1001000000000000000000001
111111111011000001110000000000001
100000000011000001110111110111111
11110111111111011100000010001
11110111111111011101010010001
11000000110101011100000010001
10002000000000001100000010001
10000000000000001101010010N01
1100000111010101110101101000111
11110111 1110101 101111010001
11111111 1111111 111111111111
