R 1920 1080

F 128, 128, 128
C 105, 106, 107
NO /home/user42/cub3d/img/redbrick.xpm
SO /home/user42/cub3d/img/redbrick.xpm
WE /home/user42/cub3d/img/redbrick.xpm
EA /home/user42/cub3d/img/redbrick.xpm
S /home/user42/cub3d/img/barrel.xpm

1111111111111111111
1000000000000000001
1000000000000000001
1000000000000000001
1000000000000000001
100000000S000000001
1000000000000000001
1000000000000000001
1000000000000000001
1000000000000000001
1000000002000000001
1000000000000000001
1000000000000000001
1000000002000000001
1000000000000000001
1000000000000000001
1000000000000000001
1000000000000000001
1000000000000000001
1000000000000000001
1111111111111111111
