R 1080 720
NO ./textures/greystone.xpm
SO ./textures/redbrick.xpm
EA ./textures/wood.xpm
WE ./textures/colorstone.xpm
S ./textures/pillar.xpm
C 135,206,235
F 122,122,122

                                        111111
                                        11000111111111
11111111111111111                       11000000000001
100000000000000011111111111111111111111111000000000001
102000002000002000000000000000000000000000000000000001
100000000000000011111111111111111111111111111111011111
10002000200020001                              101
10000000000000001                              101111111111111111
10202020N02020201                              100000000000000001
10000000000000001                              111111111111111101
10002000200200001                                             101
10000000000000001111111111111111111111111111111111111111111111101
10200000200002000000000000000000000000000000000000000000000000001
10000000000000001111111111111111111111111111111111111111111111101
11111011111111111                                             101
    101                                                       101
11111011111111111                                             101
10000000000000001                                             101
10200000200000201                                             101
10000000000000001111111111111111111111111111111111111111111111101
10002000200020000000000000000000000000000000000000000000000000001
10000000000000001111111111111111111111111111111111111111111111111
10202020002020201
10000000000000001
10002000200200001
10000000000000001
10200000200002001
10000000000000001
11111111111111111
